11111111111111111111111
100P0000000000000011111
111011100000C0000001111
10000110000000011111111
11001111111111100000001
10000010000000000111111
11000000000000011111111
11101110000E000000C1111
11101110000000000011111
10000110000000011111111
10111111111111000000011
10000C1C000000001111111
11111111111111111111111
